always	r	at all times; all the time and on every occasion	I will always be there to help you
another	s	any of various alternatives; some other	put it off to another (or some other) day
away	s	not present; having left	he's away right now
bates	v	moderate or restrain; lessen the force of	He bated his breath when talking about this affair
better	n	something superior in quality or condition or effect	a change for the better
body	n	the entire structure of an organism (an animal, plant, or human being)	he felt as if his whole body were on fire
came	v	move toward, travel toward something or somebody or approach something or somebody	He came singing down the road
cannot	No part of speech available	No definition available	No example available
churchill	n	English general considered one of the greatest generals in history (1650-1722)	No example available
come	n	the thick white fluid containing spermatozoa that is ejaculated by the male genital tract	No example available
could	No part of speech available	No definition available	No example available
day	n	time for Earth to make a complete rotation on its axis	two days later they left
dear	n	a beloved person; used as terms of endearment	No example available
done	v	engage in	make love, not war
elton	No part of speech available	No definition available	No example available
emma	No part of speech available	No definition available	No example available
enough	n	an adequate quantity; a quantity that is large enough to achieve a purpose	enough is as good as a feast
even	n	the latter part of the day (the period of decreasing daylight from late afternoon until nightfall)	he enjoyed the evening light across the lake
ever	r	at any time	did you ever smoke?
every	s	(used of count nouns) each and all of the members of a group considered singly and without exception	every person is mortal
fairfax	No part of speech available	No definition available	No example available
father	n	a male parent (also used as a term of address to your father)	his father was born in Atlanta
felt	n	a fabric made of compressed matted animal fibers	No example available
first	n	the first or highest in an ordering or series	He wanted to be the first
frank	n	a member of the ancient Germanic peoples who spread from the Rhine into the Roman Empire in the 4th century	No example available
friend	n	a person you know well and regard with affection and trust	he was my best friend at the university
give	n	the elasticity of something that can be stretched and returns to its original length	No example available
go	n	a time for working (after which you will be relieved by someone else)	it's my go
going	n	the act of departing	No example available
good	n	benefit	for your own good
great	n	a person who has achieved distinction and honor in some field	he is one of the greats of American music
half	n	one of two equal parts of a divisible whole	half a loaf
happy	a	enjoying or showing or marked by joy or pleasure	a happy smile
harriet	No part of speech available	No definition available	No example available
hartfield	No part of speech available	No definition available	No example available
heard	v	perceive (sound) via the auditory sense	No example available
highbury	No part of speech available	No definition available	No example available
home	n	where you live at a particular time	deliver the package to my home
hope	n	a specific instance of feeling hopeful	it revived their hope of winning the pennant
however	r	despite anything to the contrary (usually following a concession)	although I'm a little afraid, however I'd like to try it
indeed	r	in truth (often tends to intensify)	they said the car would break down and indeed it did
jane	No part of speech available	No definition available	No example available
knightley	No part of speech available	No definition available	No example available
know	n	the fact of being aware of information that is known to few people	he is always in the know
last	n	the temporal end; the concluding time	the stopping point of each round was signaled by a bell
like	n	a similar kind; ,	dogs, foxes, and the like
little	n	a small amount or duration	he accepted the little they gave him
long	v	desire strongly or persistently	No example available
look	n	the feelings expressed on a person's face	a sad expression
love	n	a strong positive emotion of regard and affection	his love for his work
made	v	engage in	make love, not war
make	n	a recognizable kind	there's a new brand of hero in the movies now
man	n	an adult person who is male (as opposed to a woman)	there were two women and six men on the bus
many	a	a quantifier that can be used with count nouns and is often preceded by `as' or `too' or `so' or `that'; amounting to a large but indefinite number	many temptations
may	n	the month following April and preceding June	No example available
might	n	physical strength	No example available
mind	n	that which is responsible for one's thoughts and feelings; the seat of the faculty of reason	his mind wandered
miss	n	a young woman	a young lady of 18
moment	n	a particular point in time	the moment he arrived the party began
mr	n	a form of address for a man	No example available
mrs	n	a form of address for a married woman	No example available
much	n	a great amount or extent	they did much for humanity
must	n	a necessary or essential thing	seat belts are an absolute must
never	r	not ever; at no time in the past or future	I have never been to China
nothing	n	a quantity of no importance	it looked like nothing I had ever seen before
oh	n	a midwestern state in north central United States in the Great Lakes region	No example available
one	n	the smallest whole number or a numeral representing this number	he has the one but will need a two and three to go with it
pleasure	n	a fundamental feeling that is hard to define but that people desire to experience	he was tingling with pleasure
poor	n	people without possessions or wealth (considered as a group)	the urban poor need assistance
quite	r	to a degree (not used with a negative)	quite tasty
rather	r	on the contrary	rather than disappoint the children, he did two quick tricks before he left
really	r	in accordance with truth or fact or reality	she was now truly American
room	n	an area within a building enclosed by walls and floor and ceiling	the rooms were very small but they had a nice view
said	v	express in words	He said that he wanted to marry her
say	n	the chance to speak	let him have his say
see	n	the seat within a bishop's diocese where his cathedral is located	No example available
seemed	v	give a certain impression or have a certain outward aspect	She seems to be sleeping
shall	No part of speech available	No definition available	No example available
soon	r	in the near future	the doctor will soon be here
still	n	a static photograph (especially one taken from a movie and used for advertising purposes)	he wanted some stills for a magazine ad
sure	a	having or feeling no doubt or uncertainty; confident and assured	felt certain of success
take	n	the income or profit arising from such transactions as the sale of land or other property	the average return was about 5%
thing	n	a special situation	this thing has got to end
think	n	an instance of deliberate thinking	I need to give it a good think
though	r	(postpositive) however	it might be unpleasant, though
thought	n	the content of cognition; the main thing you are thinking about	it was not a good idea
time	n	an instance or single occasion for some event	this time he succeeded
two	n	the cardinal number that is the sum of one and one or a numeral representing this number	No example available
upon	No part of speech available	No definition available	No example available
us	n	North American republic containing 50 states - 48 conterminous states in North America plus Alaska in northwest North America and the Hawaiian Islands in the Pacific Ocean; achieved independence in 1776	No example available
way	n	how something is done or how it happens	her dignified manner
well	n	a deep hole or shaft dug or drilled to obtain water or oil or gas or brine	No example available
weston	n	United States photographer(1886-1958)	No example available
wish	n	a specific feeling of desire	he got his wish
without	No part of speech available	No definition available	No example available
woman	n	an adult female person (as opposed to a man)	the woman kept house while the man hunted
woodhouse	No part of speech available	No definition available	No example available
would	No part of speech available	No definition available	No example available
yes	n	an affirmative	I was hoping for a yes
young	n	any immature animal	No example available
